111111111111111
10C000C010C0001
10F0C00F1000001
10C000C000F0001
100C00F01000E01
1P0000001C00001
111111111111111
